111111111111111111111111
1Q00000011100000Q000Q0C1
10C00111C011P100000Q0001
100011100101110000110001
100C0Q10Q00100000C000001
1000000010001000000C0001
10Q0Q001010101000Q00Q001
10000C0000100010000Q0001
101110Q0000Q0010000C0001
101C10000C0000000Q000001
1000Q00000001000Q0000001
1Q00Q00Q0Q000Q00E0Q0C001
10Q000Q0000000Q0Q0000011
1000C00110000Q000C0Q00C1
111111111111111111111111