111111111111111111111111
1001000Q00001P0000000001
1C0110Q000001110QQ000001
100000000000000000000001
100C000Q000Q00000C000001
1000000010001000000C0001
1000Q001010101000Q000001
100000100010001000000001
1000001000000010000C0001
100C000100Q0010000Q00001
100000001000100000000001
1000000001010000E000C001
100000000010000000000001
1000C00000QQ000000Q00001
111111111111111111111111
111111111111111111111111