1111111111111111111111111111111111111111111111111111111111111111111111
1000000000000000000000000000000000000000000000000000000000000000000001
1000000000000000000000000000000000000000000000000000000000000000000001
100000000000000000000000000000000000000000000000000E000000000000000001
1000000000000000000000000000000000000C00000000000000000000000000000001
1000000000011111111100000000000000000000000000000000000000000000000001
1000000000000000000000000000000000000000000000000000000000000000000001
10000000000000000000000000000000C0000000000000000000000000000000000001
1000000000000000000000000000000000000000000000000000000000000000000001
1000000000000000000000000000000000000000000000000000000000000000000001
1000000000000000000000000000000000000000000000000000000000000000000001
10000000000000000P0000000000000000000000000000000000000000000000000001
1000000000000000000001110000000000000000000000000000000000000000000001
1000000000000000000000C00C00000000000000000000000000000000000000000001
100000000000000000000000000000000000000000000000000E000000000000000001
1000000000000000000000001100000000000000000000000000000000000000000001
100000000000000000000000000000000C000000000000000000000000000000000001
1000000000000000000000000000000000000000000000000000000000000000000001
1000000000000000000000C00000000000000000000000000000000000000000000001
100000000000000000000000000000000C00000000000000000E000000000000000001
1000000000000000000000000000000000000000000000000000000000000000000001
10000000000000000000000000000000C0000000000000000000000000000000000001
1000000000000000000000000000000000000000000000000000000000000000000001
1000000000000000000000000000000000000000000000000000000000000000000001
1000000000000000000000000000000000000000000000000000000000000000000001
1111111111111111111111111111111111111111111111111111111111111111111111