111111
10P0C1
110001
1E0101
111111