1111111111
100000Q111
1011000Q01
10000P0001
1C0000Q0C1
1E00Q11001
1111111111